WWWWWWWWWWWWWWWWWWWWWWWWWWWW
WDDDDDDDDDDDDWWDDDDDDDDDDDDW
WDWWWWDWWWWWDWWDWWWWWDWWWWDW
WBWWWWDWWWWWDWWDWWWWWDWWWWBW
WDWWWWDWWWWWDWWDWWWWWDWWWWDW
WDDDFDDDDDDDDDDDDDDDDDDDDDDW
WDWWWWDWWDWWWWWWWWDWWDWWWWDW
WDWWWWDWWDWWWWWWWWDWWDWWWWDW
WDDDDDDWWDDDDWWDDDDWWDDDDDDW
WWWWWWDWWWWWDWWDWWWWWDWWWWWW
WWWWWWDWWWWWDWWDWWWWWDWWWWWW
WWWWWWDWWDDDDDDDDDDWWDWWWWWW
WWWWWWDWWDWWWRRWWWDWWDWWWWWW
WWWWWWDWWDWRRRRRRWDWWDWWWWWW
WWWWWWDDDDWRRRRRRWDDDDWWWWWW
WWWWWWDWWDWRRRRRRWDWWDWWWWWW
WWWWWWDWWDWWWWWWWWDWWDWWWWWW
WWWWWWDWWDDDDFDDDDDWWDWWWWWW
WWWWWWDWWDWWWWWWWWDWWDWWWWWW
WWWWWWDWWDWWWWWWWWDWWDWWWWWW
WDDDDDDDDDDDDWWDDDDDDDDDDDDW
WDWWWWDWWWWWDWWDWWWWWDWWWWDW
WBWWWWDWWWWWDWWDWWWWWDWWWWBW
WDDDWWDDDDDDDDDDDDDDDDWWDDDW
WWWDWWDWWDWWWWWWWWDWWDWWDWWW
WWWDWWDWWDWWWWWWWWDWWDWWDWWW
WDDDDDDWWDDDDWWDDDDWWDDDDDDW
WDWWWWWWWWWWDWWDWWWWWWWWWWDW
WDWWWWWWWWWWDWWDWWWWWWWWWWDW
WDDDDDDDFDDDDDDDDDDDDDDDDDDW
WWWWWWWWWWWWWWWWWWWWWWWWWWWW